1111111111111111111111111111111111
1E000000000F000C00000C000000000001
10100101001000001010010000F0010101
101001001010101F001001000000010101
1P0000000C00C0000000000000000000C1
1111111111111111111111111111111111